R
S->CB|WC|WD|RE|RF|RG|RI|
B->LM|
C->RR|
D->RU|
E->EY|
F->E[|
G->E`|
I->Ec|
J->E|
L->SJ|
M->OL|
N->N|
O->LN|
P->EO|
Q->TP|
R->IQ|
A->E|
T->TA|
U->IT|
V->N|
W->LV|
X->DW|
Y->AX|
Z->D|
[->AZ|
\->E|
]->T\|
^->I]|
_->R^|
`->W_|
a->T|
b->Ea|
c->Sb|
